00W0Z0L0E0W00
B0W0I0L0I0W0H
00W0Y0L0Y0W00
0WW000L000WW0
000000L000000
000000L000000
00K000L000X00
000000L000000
000000L000000
VIS000L000AIN