00WB000000W00
00WLLL00V0W00
00W00000I0W00
00W0AIS0Q0W00
00W0000000W00
00WWWWWWWWW00
0000000000000
000GIX0000000
0000000000000
00VIS000ZIY00