F00GZV0000KIS
RR0IIILLB0000
00WXYSWRRRRR0
A0WWWWW00E0R0
00WVISWF000R0
00P0IRR0000R0
00R000RAIQ0R0
00RRRRRRRRRR0
0000I00000000
00E0000EIP00A
