00VIS0000ZIY0
0WWW00WWWWW00
0WBW00WE0XW00
0W0W00WEIMW00
0W0W00WW0WW00
0WHWWWWW0WW00
0W0R000H00W00
0WWWWWWWWWW00
0000000000000
000KIP0000000